NO ./path_to_the_north_texture.png
SO ./path_to_the_south_texture.png
WE ./path_to_the_west_texture.png
EA ./path_to_the_east_texture.png

C 225,30,0
F 220,100,0

1111111111
1000000001
1000110001
1000010001
1000110001
1000000001
1000000001
1000N00001
1000000001
1111111111
